x x x x x x x x x x x x x x x x x x x x x x x x x x x x x x x x x x x x x x x x x x x x x x x x x x x x x x x x x x x x x x x x x x x x x x x x x x x x x x x x x x x x x x x x x x x x x x x x x x x x x x x x x 
x x x x x x x x x x x x x x x x x x x x x x x x x x x x x x x x x x x x x x x x x x x x x x x x x x x x x x x x x x x x x x x x x x x x x x x x x x x x L T T T T T T T T T T T R x x x x x x x x x x x x x x x x 
x x x x L T T T R x x x x L R x x x x x x x x x x x x x x x x x x x x x x x x x x x x x x x x x L R x x x x x x x x x x x x x x x x x x x x x x x x L T B x x x x x x x x x x x x x x x x x x x x x x x x x x x x 
x x x x x x x B B R x x x B B x x L T R x x x x x x x x x x x x x x L R x x x x x x x x x x x x x B T T T T T T R x x x x x x x x x x x x L R x x x x x x x x x x x x x x x x x x x L T R x x x x x x x x x x x x 
x x x x x x x x x x x x x x x x x B B B x x x x x x x x L T T T T T B B T T T R x x x x x x x x x x x x x x x x x x x x x x x x x x x x x B x x x x x x x x x x x x x x x L T T T T B B x x L T R x x x x x x x x 
x x x x x x x x x x x x x x x x x x x B x x x x x x x x x x x x x x x x x x x x x x x x x x x x x x x x x x x x x x x x x x L T T T T T T B x x x L R x x x x x x x x x x x x x x x x x x x x x x x x x x x x x x 
x x x x x x L T T T T R x x x x x x x B R x x x x x x x x x x x x x x x x x x x x x x x x x x x x x L T T T T T T R x x x x x x x x x x x x x x x x x x x x L T T T T T R x x x x x x x x x x x x x x L T T R x x 
x x x x x x x x x x x x x x x x x x x B B T T T T T T R x x x x x x x x x L T T T T T T T T T R x x x x x x x x x B R x x x x x x x x x x x x x x x x x x x x x x x x x B R x x x x x x x x x x x x x x x x x x x 
x x x x x x x x x L R x x x x x x x x x x x x x x B B B T R x x x x x x L B x x x x x x x x x x x x x x x x x x x x x x x x x x x x x x x x x x x L T T R x x x x x x x x x x x x x x x x x x x x x x x x x x x x 
x x x x x x x x x B B T T R x x x x x x x x x x x x x x x x x x x x x x x x x x x x x x x x x x x x x x x x x x x x x x x x x x x x x L T T T T T B x x x x x x x x x x x x x x x x x x x L T T T R x x x x x x x 
x x x x x x x x x x x x x x x x x x x x x x x x x x x x x x x x x L R x x x x x x x x x x x L T T T T T R x x x x x x x L R x x x x x x x x x x x x x x x x x x x x L T T T R x x x x x L B B x x x x x x x L R x 
x x L T T T T T T T T T T T T R x x x x x x x x x x x x x x x L T B x x x x x x L T T R x x x x B B B x x x x x x x L T B B T R x x x x x x x x x L T T T T T T T T B x x x B T T T T T B B x x x x x x x x x x x 
x x x x x x x x x x x x x x x x x x x x x x x x x x x x x x x x x x x x x x x x x x x x x x x x B x x x x x x x x x x x x x x B R x x x x x x x x x x x x x x x x x x x x x x x x x x x x x x x x x x x x x x x x 
x x x x x x x x x x x x x x x x L T T T T T T T T R x x x x x x x x L T R x x x x x x x x x x L B x x x x x x x x x x x x x x x x x x x x x x x x x x x x x x x x x x L T T R x x x x x x x x x x x x L T T R x x 
x x x x x x x x x x x x x x L T B B x x x x x x x x x x x L T T T T B x x x x x x x x x x x L B x x x x x x L T T T T R x x x x x x x x L T T T T T T R x x x x x x L B B B B R x x x x x x x x x x x x x x x x x 
x x x x x x x x x x x x x x x x x x x x x x x x x x x x x x x x x x x x x x x x x x x x x L B x x x x x x L B x x x x x x x x x x x x x x x x x x x x x x x x x x x x x x x x x x x x x x x x x x x x x x x x x x 
x x x x x x x x L R x x x x x x x x x L R x x x x x x x x x x x x x x x x x x x x x x x x x x x x x x L T B x x x x x x x x x x x x x x x x x x x x x L T R x x x x x x x x x x x x x x x x L T R x x x x x x x x 
x x x x x x x x B B R x x x x x x x L B B T T T T T R x x x x x L T T T R x x x x x x x x x x x x L T B x x x x x x x x x x x x x L T R x x L T T T T B x B T R x x x x x x x x x L R x x x x x x x x x x L T T R 
x L R x x x x x B B B R x x x x x x x x x x x x x x x x x x x x x x x x x x x x x x L T R x x x x x x x x x x x x x x x x x x x x x x x x x x x x x x x x x x x x x x L T T T T T B B T R x x x x x x x x B B B B 
x x B R x x x L B x x B R x x x x x x x x x x x x x x x x x x x x x x x x L T T T T B x x x x x x x x x x x x x x x x x x x x x x x x x x x x x x x x x x x x x x x x x x x x x x x x x x x x L T T R x x x x x x 
x x x x x x x x x x x x B T T T T T T T T T T R x x x x L R x x x x x x L B x x x x x x x x x x x x x x x x L T T T T T R x x x x x x x x x x x x x L T T T T R x x x x x x x x x x x x x x x x x B B x x x x x x 
x x x x x x x x x x x x x x x x x x x x x x x x x x x x B B x x x x x x x x x x x x x x x x L T T R x x x x B x x x x x B R x x x x x x x L R x x x x x x x x x x x x x x x L T R x x x x L R x x B B R x x x x x 
x x x x L R x x x x x x x x x x x x x x x x x x x x x x B B x x x x x x x x x x x x x x x x x x x B T T T T B x x x x x x x x x x x L T T B B T R x x x x x x x x x x x x L B B x x x x x x x x x B B B x x x x x 
x x x x x B R x x x x x L T T T R x x x x x x x x x L T B B x x x L T R x x x x x x x x x x x x x x x x x x x x x x x x x x x x x x x x x x x x B R x x x x x x x L T T T B B x x x x x x x x x x B B x x x x x x 
x x x x x x B T R x x x x x x x B R x x x x x x x x x x x x x x x x x B T T T T T T T T R x x x x x x x x x x x x x x x L T T T T R x x x x x x x x x x x x x x x x x x x x B x x x x x L R x x x B B x x x L T R 
x x x x x x x x x x x x x x x x x B T R x x x x x x x x x x x x x x x x x x x x x x x x B R x x x x x x x x x x x x x L B x x x x B x x x x x x x x x x L R x x x x x x x x B x x L R x x x x x x x x x x x B B B 
x x x x x x x L T T R x x x x x x x x x x x x L T T T T R x x x x x x x x x x x x x x x x x x x x x x x x x x x x x L B x x x x x B x x x x x x x x x L B x x x x x x x x x x x x x B R x x x x x x x x x x B B B 
x x x x x x x x x x x x x L R x x x x x x x x x x x x x B R x x x x x L T T R x x x x L T T R x x x L T R x x x x x x x x x x x x x x x x x x x x x L B x x x x x x x x x x x x x x x B R x x x x x x x L T B B B 
x x x x x x x x x x x x x x x x x x L R x x x x x x x x x x x x x x L B x x B R x x x x x x x x x x B B B x x x x x x x x x x x x x x x x x x x x L B x x x x x x x x x L T R x x x x x B R x x x x x x B B B B B 
x x x x x x x x x L T R x x x x x x x B T T T L x x x x x x x x x x x x x x x B T R x x x x x x x x B x B T T T T T T T R x x x x x x x L T T T T B x x x x x x x x x L B x B R x x x x x B R x x x x L B B B B B 
x x x x x x x x x x x x x x x x x x x x x x x x x x x x x x x x x x x x x x x x x B R x x x x L T T B x x x x x x x x x x x x x x x x L B x x x x x x x x x x x x x L B x x x B R x x x x x x x x x x x x x x x x 
x x x L T T T T T T T R x x x L T T T T T T T T T T T T T T R x x x x x x x x x x x x x x x x x x x x x x x x x x x x x x x x x x x x x x x x x x x x x x x x x x L B x x x x x B R x x x x x x x x x x x x x x x 
x x x x x x x x x x x x x x x x x x x x x x x x x x x x x x B T R x x x x x x x x x x x x x x x x x x x x x x x x x x x x x x x x x x x x L R x x x x L T T T T T B x x x x x x x B T T T T T T T T R x x x x x x 
x x x x x x x x x x x x x x x x x x x x x x x x x x x x x x x x x x x x x x L T T T T T T T T T T T T T T R x x x x L T T T T T T T T T T B x x x x L B x x x x x x x x L T R x x x x x x x x x x x x x x x L T R 
x L R x x x x x x L R x x x x x x x x x x x x L T R x x x x x x x x x x x x x x x x x x x x x x x x x x x x x x x x x x x x x x x x x x x x x x x x x x x x x x x x x x x x x x x x x x x x x x x x x x x x x x x
x x x x x x x x x B B T R x x x x x x x x x x x x B T T R x x x x x x x x x x x x x x x x x x x x x x x x x x x x x x x x x x x x x x x x x x x x x x x x x x x x x L T T T R x x x x x x L R x x x x x x x x x x 
x x x x L T T T T B x x B T T T T T T R x x x x x x x x B x x x x x L R x x x x x x x x L T T R x x x R T T L x x x x L R x x x x x x x x x x x x x x x x L T T T T B x x x B T T T T T T B x x x x x x L R x x x 
x x x x x x x x x x x x x x x x x x x x x x x x x x x x B T T T T T B B T T R x x L T T B x x B R x x x x x B x x x x x B T x x x x x x x L T T R x x x x x x x x x x x x x x x x x x x x x x x x x L T B x x x x 
x x x x x x x x x x x x x x x x x x x x x x x L T T T T B x x x x x x x x x x x x x x x x x x x x x x x x x B x x x x x x B T T T x x x x x x x x x x x x x x x x x x x x x x x x x x x x x x x L T B x x x x L R 
x L T R x x x x x x L T T R x x x x x x x x x x x x x x x x x x x x x x x x x x x x x x x x x x x x x x x x B R x x x x x x x x x x x x x x x x x x x L T T T T R x x x L T T R x x L R x x x L B B B x x x x B B 
x x B B R x x x L T B B B x x x x x x L R x x x x x x x x x x L T R x x x L R x x x x x x x x L R x x x x x x x x x x x x x x x x x x x L T T R x x x x x x x x x x x x B x x B x x x x x x x x x x x x x x x B B 
x x x x x x x x x x x x B x x x x x x x x x x x x L R x x x x B x x x x x x B T T T T T T T T B x x x x x x x x x x x x L T T T R x x x x x x x x x x x x x x L T R x x B x x B x x x x x x x x x x x x x x L B B 
x x x x x x x x x x x x B T R x x x x L T T T T T B B T T T T B x x x x x x x x x x x x x x x x x x x x x x x x x x L T B x x x B R x x x x x x x x x x x x x x x x x x B x x B T T T T R x x x x x x x x x x x x 
x x x x L T R x x x x x x x x x x x x x x x x x x B B x x x x x x x L T R x x x x x x x x x x x x x L T T T T R x x x x x x x x x x x x x x L T T T T T R x x x x L T T B x x x x x x x x x x x x x x x x x x x x 
x x x x x x x x x x x x x x x x x x x x x x x x x B B x x x x x x x x x x x x x x x x x x x x x x x x x x x x x x x x x x x x x x x x x x x B x x x x x x x x x L B x x x x x x x x x x x x x x L T T T R x x x x 
x x x x x x x x x x x x x L T T T T T T T T T T T B B T T R x x x x x x x x x x x x x x L T T T R x x x x x x x x x x x x x x x x x L T T T B x x x x x x x x L B x x x x x x x x L T T T T T T B x x x x x x x x 
x x x x x x x x L T R x x x x x x x x x x x x x x x x x B B T R x x x x x x x x x x x L B x x B B x x x x x x x x x x x x x x x x x x x x x x x x x L T T T T B x x x x x x x x x x x x x x x x x x x x x x x L R 
x x x x x x x x x x x x x x x x x x x x x x x x x x x x x x x x x x x x x x x x x x L B x x x x B T T T T R x x x x x x x x x x x x x x x x x x x x x x x x x x x x x x x x L T R x x x x x x x x x x x x x x x x 
x x x x x x x x x x x x x x x x L T T R x x x x x x x x x x x x x x x x x x x L T T B x x x x x x x x x x x x x x x x x x x L T T T T T T T R x x x x x x x x x x x x x x x x B B T R x x x x x x x x x x x x x x 
x x x x x L T T T T T T T T T T B x x B R x x x L T T T T T T T T T T T T T T B B B x x x x x x x x x x x x x x x x x x x x x x x x B x x x x x x L R x x x x x x x L R x x x x x x B R x x x x x x x L T R x x x 
x x x x x x x x x x x x x x x x x x x x x x x x B x x x x x x x x x x x x x x x x x x x x x x x x x x x x x x x x L T R x x x x x x B x x x x x x x B T T T T T T T B x x x x x x x x B T T R x x x x x x x x x x 
x L R x x x x x x x x x x x x x x x x x x x x x B x x x x x x x x x x x x x x x x x x x x L T R x x x x x x x x x x x x x x x x x x x x x L R x x x x x x x x x x x x x x x L R x x x x x x x x x x x x x x x x x 
x x B R x x x x x x x x x x x x x x L T T R x x B x x x L T T R x x x x x x x x x x x x x x x x x x L R x x x L R x x x x x x L R x x x x x B R x x x x x x x x x x x x L T B B T R x x x x x x x x L T T T T T R 
x x B B T R x x x x x x L T T R x x x x x x x x x x x x x x x x x x x x x x x x L T R x x x x x x x x B T T T B x x x x x x L B B R x x x x x x x x x x x x x x x x x x x x x x x x x x x x x x x x x x x x x x x 
x x x x x x x x x x L T B B B x x x x x x x x L T T R x x x x x x x x L R x x x x x x x x x x x x x x x x x x x x x L R x x x x x x x x x x x x x x x x x x L T T R x x x x x x x x x x x x x x x x x x x x x x x 
x x x x x x x x x x x x x x x x x x x x x x x x x x x x x x x x x x L B B R x x x x x x x x L T T R x x x x x x x L B x x x x x x x x x L T T T T T R x x x x x x B T R x x x x x L R x x x x L R x x x x x x x x 
x x x x L T T R x x x x x x x x x L T T R x x x x x x x L T T R x x x x x x x x x x x x x x x x x B T T T T T T T B x x x x x x x x x x x x x x x x x x x x x x x x x x x x x x x x B T T T T B x x x x x x x x x
x x x x x x x x x x x x x x x x x x x x x x x x x x x x x x x x x x x x x x x x x x x x x x x x x x x x x x x x x x x x x x x x x x x x x x x x x x x x x x x x x x x x x x x x x x x x x x x x x x x x x x x x x